48,64
9999999999999999999999999999999999999999999999999999999999999999
9000000000000000003300007000000000000000000000000000000000000809
9000000000000000003300000000000000000000000000000000000000000009
9000000000000000003300000600000000000000000000090000000000000009
9000003330000000003300000000000009999900000000090000000000000009
9000003330000000003300000000000000000000000000090000000000000009
9000003330000000003300000000200000000000000000090000333333330009
9000003330000000003300000000200000000000000000090000000000000009
9000003330000000003300000000200000000000000000000000000000000009
9000003330000000003300000000200000000000000000000000000000000009
9000000000003330000000000000200000000000000022222220000000000009
9000000000003338000000000000233330000000000022222220000000000009
9006000000003330002200000000222220000000000022222220000006000009
9000000000003330002200000000200000000000000000000000030000000009
9000000000003330002200000000200700000000000000000000030000000009
9000000000000000002200000000200000333333330000000000030000000009
9000000000000000009900000000200000333333330000000000030000020009
9000000000000000009900009900200000000200000000000000830000020009
9070000000000000002200002200000000000200000000000000030007020009
9000000000000000002200002900000000033200000000000000030000020009
9000333333333300002200002200000000000200000000000000030000020009
9000222222200000002200002200000000000200000000000000000000020009
9000222222200000000000002200029930000200000000000000000002222229
9000222222200000000000002200095020002222200000220000000000020009
9000000000000000000000002200020030000000000000220000030000020009
9000000000000000000000002200032290000000000000220000030000020009
9000000600000000003000002200000000000009999000220000030000020009
9000000000000000003000002200000000000000000000220000030000020009
9000000003000000003000003200000000000000000000220000030000020009
9000000003000000003000003200222222003000000000220000030000020009
9000000003000000003000003200333333003000000000220000038000000009
9000000003000000003000003200000000003222222000220000030000000009
9330000003000000003000003200000000003222222000220000030000000009
9330000003000000003000003200000000003000000000220000000000000009
9330022223222200003000003200000000003000000000220000000000000009
9330000003000000000000003200000000003000000000330007000000000009
9330000003000000000000003200002200003000000000220000000000000009
9330000003000000222220003200002200003000000000220000000000000009
9330000003000000000000003200002200003000000000220000000000000009
9330000003000000000000003200002200003000000000220000000000000009
9000000003000000000080003200002200000000000000220000000000000009
9000000000000000000000003200002200000000000000220000000000000009
9000000000000000000000000000000000600000000000220000002222220009
9000000000000002220000000000000000000000000000000333002222220009
9000000000000002220000000000000000000000000000000000000000000009
9000000000000002220000000000000000000700033330000000000000000009
9000000000000002220000000000000000000000033330000000000000000009
9999999999999999999999999999999999999999999999999999999999999999
